Original Community,Original Size,Matched Reduced Community,Reduced Size,Intersection Size,Retention (%),Size Change
0,323,3,61,34,10.526315789473683,262
1,154,2,64,55,35.714285714285715,90
2,148,8,40,25,16.89189189189189,108
3,119,0,119,119,100.0,0
4,108,11,35,35,32.407407407407405,73
5,82,22,23,23,28.04878048780488,59
6,76,70,9,9,11.842105263157894,67
7,76,4,53,8,10.526315789473683,23
8,73,8,40,15,20.54794520547945,33
9,70,1,76,51,72.85714285714285,-6
10,70,9,39,39,55.714285714285715,31
11,68,17,25,25,36.76470588235294,43
12,65,5,49,49,75.38461538461539,16
13,49,259,4,4,8.16326530612245,45
14,46,16,25,25,54.347826086956516,21
15,45,42,13,13,28.888888888888886,32
16,36,24,22,16,44.44444444444444,14
17,35,6,42,35,100.0,-7
18,33,7,41,32,96.96969696969697,-8
19,32,25,20,20,62.5,12
20,30,12,30,30,100.0,0
21,30,705,1,1,3.3333333333333335,29
22,29,18,25,25,86.20689655172413,4
23,29,10,36,29,100.0,-7
24,27,14,27,27,100.0,0
25,26,15,26,26,100.0,0
26,23,21,23,23,100.0,0
27,23,3,61,23,100.0,-38
28,22,73,9,9,40.909090909090914,13
29,21,4,53,21,100.0,-32
30,20,26,20,20,100.0,0
31,20,27,20,20,100.0,0
32,19,28,19,19,100.0,0
33,19,29,19,19,100.0,0
34,17,32,17,17,100.0,0
35,17,33,17,17,100.0,0
36,16,34,16,16,100.0,0
37,16,35,16,16,100.0,0
38,16,36,16,16,100.0,0
39,16,37,16,16,100.0,0
40,16,40,14,14,87.5,2
41,15,38,15,15,100.0,0
42,14,41,14,14,100.0,0
43,13,43,13,13,100.0,0
44,13,44,13,13,100.0,0
45,12,45,12,12,100.0,0
46,12,46,12,12,100.0,0
47,12,47,12,12,100.0,0
48,12,49,12,12,100.0,0
49,12,50,12,12,100.0,0
50,12,52,12,12,100.0,0
51,12,53,12,12,100.0,0
52,11,54,11,11,100.0,0
53,11,55,11,11,100.0,0
54,11,56,11,11,100.0,0
55,11,57,11,11,100.0,0
56,10,58,10,10,100.0,0
57,10,2,64,9,90.0,-54
58,10,59,10,10,100.0,0
59,10,60,10,10,100.0,0
60,10,61,10,10,100.0,0
61,10,63,10,10,100.0,0
62,10,64,10,10,100.0,0
63,10,65,10,10,100.0,0
64,10,66,10,10,100.0,0
65,10,67,10,10,100.0,0
66,10,68,10,10,100.0,0
67,10,69,10,10,100.0,0
68,9,71,9,9,100.0,0
69,9,72,9,9,100.0,0
70,9,74,9,9,100.0,0
71,8,75,8,8,100.0,0
72,8,77,8,8,100.0,0
73,8,78,8,8,100.0,0
74,8,79,8,8,100.0,0
75,8,81,8,8,100.0,0
76,8,82,8,8,100.0,0
77,8,83,8,8,100.0,0
78,8,84,8,8,100.0,0
79,8,85,8,8,100.0,0
80,8,86,8,8,100.0,0
81,8,87,8,8,100.0,0
82,7,90,7,7,100.0,0
83,7,94,7,7,100.0,0
84,7,95,7,7,100.0,0
85,7,96,7,7,100.0,0
86,7,97,7,7,100.0,0
87,7,98,7,7,100.0,0
88,7,100,7,7,100.0,0
89,7,101,7,7,100.0,0
90,7,103,7,7,100.0,0
91,7,104,7,7,100.0,0
92,7,105,7,7,100.0,0
93,7,106,7,7,100.0,0
94,7,107,7,7,100.0,0
95,7,108,7,7,100.0,0
96,6,109,6,6,100.0,0
97,6,111,6,6,100.0,0
98,6,112,6,6,100.0,0
99,6,113,6,6,100.0,0
100,6,114,6,6,100.0,0
101,6,115,6,6,100.0,0
102,6,116,6,6,100.0,0
103,6,118,6,6,100.0,0
104,6,119,6,6,100.0,0
105,6,120,6,6,100.0,0
106,6,121,6,6,100.0,0
107,6,122,6,6,100.0,0
108,6,123,6,6,100.0,0
109,6,125,6,6,100.0,0
110,6,127,6,6,100.0,0
111,6,128,6,6,100.0,0
112,6,129,6,6,100.0,0
113,6,131,6,6,100.0,0
114,6,133,6,6,100.0,0
115,5,134,5,5,100.0,0
116,5,135,5,5,100.0,0
117,5,136,5,5,100.0,0
118,5,138,5,5,100.0,0
119,5,139,5,5,100.0,0
120,5,140,5,5,100.0,0
121,5,141,5,5,100.0,0
122,5,142,5,5,100.0,0
123,5,143,5,5,100.0,0
124,5,144,5,5,100.0,0
125,5,145,5,5,100.0,0
126,5,147,5,5,100.0,0
127,5,148,5,5,100.0,0
128,5,149,5,5,100.0,0
129,5,150,5,5,100.0,0
130,5,151,5,5,100.0,0
131,5,153,5,5,100.0,0
132,5,155,5,5,100.0,0
133,5,157,5,5,100.0,0
134,5,158,5,5,100.0,0
135,5,159,5,5,100.0,0
136,5,160,5,5,100.0,0
137,5,161,5,5,100.0,0
138,5,164,5,5,100.0,0
139,5,165,5,5,100.0,0
140,5,166,5,5,100.0,0
141,5,167,5,5,100.0,0
142,5,168,5,5,100.0,0
143,4,170,4,4,100.0,0
144,4,171,4,4,100.0,0
145,4,172,4,4,100.0,0
146,4,173,4,4,100.0,0
147,4,174,4,4,100.0,0
148,4,175,4,4,100.0,0
149,4,177,4,4,100.0,0
150,4,178,4,4,100.0,0
151,4,179,4,4,100.0,0
152,4,180,4,4,100.0,0
153,4,181,4,4,100.0,0
154,4,182,4,4,100.0,0
155,4,184,4,4,100.0,0
156,4,3,61,4,100.0,-57
157,4,187,4,4,100.0,0
158,4,188,4,4,100.0,0
159,4,189,4,4,100.0,0
160,4,190,4,4,100.0,0
161,4,192,4,4,100.0,0
162,4,20,23,4,100.0,-19
163,4,193,4,4,100.0,0
164,4,194,4,4,100.0,0
165,4,195,4,4,100.0,0
166,4,196,4,4,100.0,0
167,4,197,4,4,100.0,0
168,4,198,4,4,100.0,0
169,4,199,4,4,100.0,0
170,4,201,4,4,100.0,0
171,4,202,4,4,100.0,0
172,4,203,4,4,100.0,0
173,4,204,4,4,100.0,0
174,4,205,4,4,100.0,0
175,4,206,4,4,100.0,0
176,4,207,4,4,100.0,0
177,4,209,4,4,100.0,0
178,4,210,4,4,100.0,0
179,4,211,4,4,100.0,0
180,4,212,4,4,100.0,0
181,4,213,4,4,100.0,0
182,4,214,4,4,100.0,0
183,4,215,4,4,100.0,0
184,4,216,4,4,100.0,0
185,4,217,4,4,100.0,0
186,4,218,4,4,100.0,0
187,4,220,4,4,100.0,0
188,4,221,4,4,100.0,0
189,4,222,4,4,100.0,0
190,4,223,4,4,100.0,0
191,4,224,4,4,100.0,0
192,4,225,4,4,100.0,0
193,4,228,4,4,100.0,0
194,4,230,4,4,100.0,0
195,4,102,7,4,100.0,-3
196,4,231,4,4,100.0,0
197,4,232,4,4,100.0,0
198,4,234,4,4,100.0,0
199,4,235,4,4,100.0,0
200,4,236,4,4,100.0,0
201,4,237,4,4,100.0,0
202,4,239,4,4,100.0,0
203,4,240,4,4,100.0,0
204,4,241,4,4,100.0,0
205,4,242,4,4,100.0,0
206,4,243,4,4,100.0,0
207,4,244,4,4,100.0,0
208,4,245,4,4,100.0,0
209,4,246,4,4,100.0,0
210,4,247,4,4,100.0,0
211,4,248,4,4,100.0,0
212,4,249,4,4,100.0,0
213,4,250,4,4,100.0,0
214,4,252,4,4,100.0,0
215,4,254,4,4,100.0,0
216,4,255,4,4,100.0,0
217,4,256,4,4,100.0,0
218,4,257,4,4,100.0,0
219,4,258,4,4,100.0,0
220,4,260,4,4,100.0,0
221,3,261,3,3,100.0,0
222,3,262,3,3,100.0,0
223,3,263,3,3,100.0,0
224,3,265,3,3,100.0,0
225,3,266,3,3,100.0,0
226,3,267,3,3,100.0,0
227,3,268,3,3,100.0,0
228,3,269,3,3,100.0,0
229,3,270,3,3,100.0,0
230,3,271,3,3,100.0,0
231,3,272,3,3,100.0,0
232,3,273,3,3,100.0,0
233,3,274,3,3,100.0,0
234,3,275,3,3,100.0,0
235,3,276,3,3,100.0,0
236,3,277,3,3,100.0,0
237,3,278,3,3,100.0,0
238,3,279,3,3,100.0,0
239,3,280,3,3,100.0,0
240,3,281,3,3,100.0,0
241,3,282,3,3,100.0,0
242,3,283,3,3,100.0,0
243,3,286,3,3,100.0,0
244,3,287,3,3,100.0,0
245,3,288,3,3,100.0,0
246,3,289,3,3,100.0,0
247,3,291,3,3,100.0,0
248,3,292,3,3,100.0,0
249,3,293,3,3,100.0,0
250,3,294,3,3,100.0,0
251,3,295,3,3,100.0,0
252,3,296,3,3,100.0,0
253,3,298,3,3,100.0,0
254,3,299,3,3,100.0,0
255,3,300,3,3,100.0,0
256,3,301,3,3,100.0,0
257,3,302,3,3,100.0,0
258,3,303,3,3,100.0,0
259,3,306,3,3,100.0,0
260,3,307,3,3,100.0,0
261,3,309,3,3,100.0,0
262,3,310,3,3,100.0,0
263,3,311,3,3,100.0,0
264,3,312,3,3,100.0,0
265,3,313,3,3,100.0,0
266,3,314,3,3,100.0,0
267,3,315,3,3,100.0,0
268,3,318,3,3,100.0,0
269,3,319,3,3,100.0,0
270,3,322,3,3,100.0,0
271,3,323,3,3,100.0,0
272,3,324,3,3,100.0,0
273,3,325,3,3,100.0,0
274,3,326,3,3,100.0,0
275,3,327,3,3,100.0,0
276,3,328,3,3,100.0,0
277,3,329,3,3,100.0,0
278,3,330,3,3,100.0,0
279,3,331,3,3,100.0,0
280,3,332,3,3,100.0,0
281,3,333,3,3,100.0,0
282,3,334,3,3,100.0,0
283,3,335,3,3,100.0,0
284,3,336,3,3,100.0,0
285,3,337,3,3,100.0,0
286,3,338,3,3,100.0,0
287,3,341,3,3,100.0,0
288,3,342,3,3,100.0,0
289,3,343,3,3,100.0,0
290,3,344,3,3,100.0,0
291,3,345,3,3,100.0,0
292,3,347,3,3,100.0,0
293,3,348,3,3,100.0,0
294,3,349,3,3,100.0,0
295,3,350,3,3,100.0,0
296,3,352,3,3,100.0,0
297,3,353,3,3,100.0,0
298,3,354,3,3,100.0,0
299,3,355,3,3,100.0,0
300,3,356,3,3,100.0,0
301,3,357,3,3,100.0,0
302,3,358,3,3,100.0,0
303,3,360,3,3,100.0,0
304,3,361,3,3,100.0,0
305,3,362,3,3,100.0,0
306,3,364,3,3,100.0,0
307,3,365,3,3,100.0,0
308,3,367,3,3,100.0,0
309,3,368,3,3,100.0,0
310,3,369,3,3,100.0,0
311,3,370,3,3,100.0,0
312,3,371,3,3,100.0,0
313,3,372,3,3,100.0,0
314,3,373,3,3,100.0,0
315,3,374,3,3,100.0,0
316,3,375,3,3,100.0,0
317,3,378,3,3,100.0,0
318,3,379,3,3,100.0,0
319,3,380,3,3,100.0,0
320,3,381,3,3,100.0,0
321,3,382,3,3,100.0,0
322,3,383,3,3,100.0,0
323,3,384,3,3,100.0,0
324,3,385,3,3,100.0,0
325,3,386,3,3,100.0,0
326,3,387,3,3,100.0,0
327,3,388,3,3,100.0,0
328,3,389,3,3,100.0,0
329,3,390,3,3,100.0,0
330,3,391,3,3,100.0,0
331,3,392,3,3,100.0,0
332,3,393,3,3,100.0,0
333,3,394,3,3,100.0,0
334,3,395,3,3,100.0,0
335,2,396,2,2,100.0,0
336,2,397,2,2,100.0,0
337,2,398,2,2,100.0,0
338,2,400,2,2,100.0,0
339,2,401,2,2,100.0,0
340,2,402,2,2,100.0,0
341,2,403,2,2,100.0,0
342,2,404,2,2,100.0,0
343,2,405,2,2,100.0,0
344,2,406,2,2,100.0,0
345,2,407,2,2,100.0,0
346,2,408,2,2,100.0,0
347,2,409,2,2,100.0,0
348,2,410,2,2,100.0,0
349,2,411,2,2,100.0,0
350,2,412,2,2,100.0,0
351,2,413,2,2,100.0,0
352,2,414,2,2,100.0,0
353,2,415,2,2,100.0,0
354,2,416,2,2,100.0,0
355,2,417,2,2,100.0,0
356,2,419,2,2,100.0,0
357,2,420,2,2,100.0,0
358,2,421,2,2,100.0,0
359,2,422,2,2,100.0,0
360,2,423,2,2,100.0,0
361,2,424,2,2,100.0,0
362,2,425,2,2,100.0,0
363,2,426,2,2,100.0,0
364,2,428,2,2,100.0,0
365,2,429,2,2,100.0,0
366,2,430,2,2,100.0,0
367,2,432,2,2,100.0,0
368,2,433,2,2,100.0,0
369,2,434,2,2,100.0,0
370,2,436,2,2,100.0,0
371,2,437,2,2,100.0,0
372,2,438,2,2,100.0,0
373,2,439,2,2,100.0,0
374,2,440,2,2,100.0,0
375,2,441,2,2,100.0,0
376,2,442,2,2,100.0,0
377,2,444,2,2,100.0,0
378,2,447,2,2,100.0,0
379,2,449,2,2,100.0,0
380,2,450,2,2,100.0,0
381,2,451,2,2,100.0,0
382,2,452,2,2,100.0,0
383,2,453,2,2,100.0,0
384,2,454,2,2,100.0,0
385,2,456,2,2,100.0,0
386,2,457,2,2,100.0,0
387,2,458,2,2,100.0,0
388,2,459,2,2,100.0,0
389,2,460,2,2,100.0,0
390,2,461,2,2,100.0,0
391,2,462,2,2,100.0,0
392,2,464,2,2,100.0,0
393,2,465,2,2,100.0,0
394,2,466,2,2,100.0,0
395,2,467,2,2,100.0,0
396,2,468,2,2,100.0,0
397,2,469,2,2,100.0,0
398,2,470,2,2,100.0,0
399,2,471,2,2,100.0,0
400,2,472,2,2,100.0,0
401,2,473,2,2,100.0,0
402,2,474,2,2,100.0,0
403,2,475,2,2,100.0,0
404,2,476,2,2,100.0,0
405,2,477,2,2,100.0,0
406,2,478,2,2,100.0,0
407,2,480,2,2,100.0,0
408,2,482,2,2,100.0,0
409,2,484,2,2,100.0,0
410,2,487,2,2,100.0,0
411,2,488,2,2,100.0,0
412,2,489,2,2,100.0,0
413,2,490,2,2,100.0,0
414,2,491,2,2,100.0,0
415,2,492,2,2,100.0,0
416,2,496,2,2,100.0,0
417,2,497,2,2,100.0,0
418,2,498,2,2,100.0,0
419,2,499,2,2,100.0,0
420,2,500,2,2,100.0,0
421,2,501,2,2,100.0,0
422,2,502,2,2,100.0,0
423,2,503,2,2,100.0,0
424,2,504,2,2,100.0,0
425,2,506,2,2,100.0,0
426,2,507,2,2,100.0,0
427,2,508,2,2,100.0,0
428,2,509,2,2,100.0,0
429,2,510,2,2,100.0,0
430,2,511,2,2,100.0,0
431,2,512,2,2,100.0,0
432,2,513,2,2,100.0,0
433,2,514,2,2,100.0,0
434,2,515,2,2,100.0,0
435,2,517,2,2,100.0,0
436,2,518,2,2,100.0,0
437,2,519,2,2,100.0,0
438,2,520,2,2,100.0,0
439,2,521,2,2,100.0,0
440,2,522,2,2,100.0,0
441,2,523,2,2,100.0,0
442,2,526,2,2,100.0,0
443,2,527,2,2,100.0,0
444,2,529,2,2,100.0,0
445,2,532,2,2,100.0,0
446,2,533,2,2,100.0,0
447,2,534,2,2,100.0,0
448,2,535,2,2,100.0,0
449,2,538,2,2,100.0,0
450,2,540,2,2,100.0,0
451,2,541,2,2,100.0,0
452,2,542,2,2,100.0,0
453,2,543,2,2,100.0,0
454,2,544,2,2,100.0,0
455,2,545,2,2,100.0,0
456,2,546,2,2,100.0,0
457,2,547,2,2,100.0,0
458,2,548,2,2,100.0,0
459,2,549,2,2,100.0,0
460,2,550,2,2,100.0,0
461,2,551,2,2,100.0,0
462,2,552,2,2,100.0,0
463,2,553,2,2,100.0,0
464,2,554,2,2,100.0,0
465,2,555,2,2,100.0,0
466,2,556,2,2,100.0,0
467,2,557,2,2,100.0,0
468,2,558,2,2,100.0,0
469,2,559,2,2,100.0,0
470,2,560,2,2,100.0,0
471,2,561,2,2,100.0,0
472,2,562,2,2,100.0,0
473,2,563,2,2,100.0,0
474,2,564,2,2,100.0,0
475,2,565,2,2,100.0,0
476,2,566,2,2,100.0,0
477,2,567,2,2,100.0,0
478,2,568,2,2,100.0,0
479,2,569,2,2,100.0,0
480,2,570,2,2,100.0,0
481,2,571,2,2,100.0,0
482,2,572,2,2,100.0,0
483,2,573,2,2,100.0,0
484,2,574,2,2,100.0,0
485,2,575,2,2,100.0,0
486,2,576,2,2,100.0,0
487,2,577,2,2,100.0,0
488,2,578,2,2,100.0,0
489,2,579,2,2,100.0,0
490,2,580,2,2,100.0,0
491,2,581,2,2,100.0,0
492,2,582,2,2,100.0,0
493,2,583,2,2,100.0,0
494,2,584,2,2,100.0,0
495,2,585,2,2,100.0,0
496,2,586,2,2,100.0,0
497,2,587,2,2,100.0,0
498,2,588,2,2,100.0,0
499,2,589,2,2,100.0,0
500,2,590,2,2,100.0,0
501,2,591,2,2,100.0,0
502,2,592,2,2,100.0,0
503,2,593,2,2,100.0,0
504,2,595,2,2,100.0,0
505,2,597,2,2,100.0,0
506,2,599,2,2,100.0,0
507,2,600,2,2,100.0,0
508,2,601,2,2,100.0,0
509,2,602,2,2,100.0,0
510,2,603,2,2,100.0,0
511,2,604,2,2,100.0,0
512,2,605,2,2,100.0,0
513,2,606,2,2,100.0,0
514,2,607,2,2,100.0,0
515,2,608,2,2,100.0,0
516,2,611,2,2,100.0,0
517,2,612,2,2,100.0,0
518,2,613,2,2,100.0,0
519,2,614,2,2,100.0,0
520,2,615,2,2,100.0,0
521,2,616,2,2,100.0,0
522,2,619,2,2,100.0,0
523,2,620,2,2,100.0,0
524,2,621,2,2,100.0,0
525,2,622,2,2,100.0,0
526,2,624,2,2,100.0,0
527,2,625,2,2,100.0,0
528,2,626,2,2,100.0,0
529,2,627,2,2,100.0,0
530,2,628,2,2,100.0,0
531,2,629,2,2,100.0,0
532,2,630,2,2,100.0,0
533,2,631,2,2,100.0,0
534,2,632,2,2,100.0,0
535,2,633,2,2,100.0,0
536,2,634,2,2,100.0,0
537,2,635,2,2,100.0,0
538,2,636,2,2,100.0,0
539,2,637,2,2,100.0,0
540,2,638,2,2,100.0,0
541,2,639,2,2,100.0,0
542,2,640,2,2,100.0,0
543,2,641,2,2,100.0,0
544,2,642,2,2,100.0,0
545,2,645,2,2,100.0,0
546,2,646,2,2,100.0,0
547,2,647,2,2,100.0,0
548,2,648,2,2,100.0,0
549,2,649,2,2,100.0,0
550,2,651,2,2,100.0,0
551,2,652,2,2,100.0,0
552,2,653,2,2,100.0,0
553,2,654,2,2,100.0,0
554,2,655,2,2,100.0,0
555,2,657,2,2,100.0,0
556,2,658,2,2,100.0,0
557,2,660,2,2,100.0,0
558,2,661,2,2,100.0,0
559,2,662,2,2,100.0,0
560,2,663,2,2,100.0,0
561,2,664,2,2,100.0,0
562,2,665,2,2,100.0,0
563,2,666,2,2,100.0,0
564,2,667,2,2,100.0,0
565,2,668,2,2,100.0,0
566,2,669,2,2,100.0,0
567,2,670,2,2,100.0,0
568,2,671,2,2,100.0,0
569,2,672,2,2,100.0,0
570,2,673,2,2,100.0,0
571,2,674,2,2,100.0,0
572,2,676,2,2,100.0,0
573,2,677,2,2,100.0,0
574,2,678,2,2,100.0,0
575,2,679,2,2,100.0,0
576,2,680,2,2,100.0,0
577,2,681,2,2,100.0,0
578,2,682,2,2,100.0,0
579,2,683,2,2,100.0,0
580,2,684,2,2,100.0,0
581,2,685,2,2,100.0,0
582,2,686,2,2,100.0,0
583,2,687,2,2,100.0,0
584,2,688,2,2,100.0,0
585,2,689,2,2,100.0,0
586,2,690,2,2,100.0,0
